-> Para texto:
color: Define a cor da fonte.
font-size: Estabelece o tamanho da fonte.
font-weight: Especifica a intensidade da fonte (ex: negrito).
font-family: Define qual familia de fonte eu irei utilizar.
text-align: Define como o texto será alinhado.
text-decoration: coloca um underline nos links.
line-height: altera o espaço das linhas de um texto.
font-style: define a fonte em normal, italico ou oblica.

-> layout:
background: permite alterar o fundo da página, mudando a cor etc.
margin: coloca uma margem em um elemento.
padding: colca uma margem interna no elemento, ou seja, coloca uma ditância entre o conteudo de um elemento e suas bordas 
position: posiciona um elemento em um detrminado local da página.
display: define como o elemrnto veve ser renderizado. (Não entendi muito bem)
top: posiciona um elemento de acordo com om topo da página. 
bottom: posiciona um elemento de acordo com a parte inferior da página.
left: posiciona um elemento à esquerda da página.
right: posiciona um elemento à direita da página.
height: altera a altura de um elemento.
width: alter a largura de um elemento.
float: flutua um elemento em um determinado local da página.
border: ajusta o valor da borda de determinado elemento.

-> listas:
list-style: usada para configurar list-style-type, list-style-image e list-style-position. 

-> unidades
px -> pixels
pt -> pontos
% -> porcentagem
em -> tamanho padrão
cm -> centímetro
mm -> milímetro
pc -> paica
vw -> viewport width
vh -> viewport height
vmax -> viewport maximum
